WWWWWWWWWWWWWWWWWWWWWWWWW
W P                     W
W    WWWW               W
W        WWW    WWWW    W
W                       W
W      W   ww  WW   W   W
W      W       W   W    W
W   W  W       wWWWW WwwW
W      WWWWWW           W
W W w     W  W   W      W
W   WWWWWWW    W wwwwwWWW
W                       W
W      W    WWW         W
W  WWWWWWWWWW     wWW W W 
W  W        W       W   W
W  W    WWWWW           W
W  W    W          W    W
W       W          W    W
WWWWWWWWWWWWWWWWWWWWwWWWW  
