WWWWWWWWWWWWWWWWWWWWWWWWW
W P  R        E         W
W    WWWW        WWWWW  W
W   E     WWW    WWWW   W
W    WWW    WWWW        W
W      W   ww  WW   W   W
W  WWW    W   ww   E W WW
W   W  W   w    wWWWWWwwW
W      WWWWWW    WW     W
W W w     W  W   W    E W
W   WWWWWWW    W wwwwwWWW
W     WWWW       W  E   W
W WW  E   W  E  WWW     W
W  WWWWWWWWWW     wWW W W 
W  W        W   WW    W W
W  W    WWWWW           W
W  W   W          W     W
W       W     WWW WW   gW
WWWWWWWWWWWWWWWWWWWWWWWWW